12 12 12 12 12 12 12 12 12 12 12 12 12 12 12 12 12 12 12 12 12 12 12 12 12 12 12 12 12 12 12 12 12 12 12 12 12 12 12 12 12 12 12 12 12 12 12 12 12 12 
12 12 12 12 12 12 12 12 12 12 12 12 12 12 12 12 12 12 12 12 12 12 12 12 12 12 12 12 12 12 12 12 12 12 12 12 12 12 12 12 12 12 12 12 12 12 12 12 12 12 
12 12 12 12 12 12 12 12 12 12 12 12 12 12 12 12 12 12 12 12 12 12 12 12 12 12 12 12 12 12 12 12 12 12 12 12 12 12 12 12 12 12 12 12 12 12 12 12 12 12 
12 12 12 12 12 12 12 12 12 12 12 12 12 12 12 12 12 12 12 12 12 12 12 12 12 12 12 12 12 12 12 12 12 12 12 12 12 12 12 12 12 12 12 12 12 12 12 12 12 12  
12 12 12 12 12 12 12 12 12 12 12 12 12 12 12 12 12 12 12 12 12 12 12 12 12 12 12 12 12 12 12 12 12 12 12 12 12 12 12 12 12 12 12 12 12 12 12 12 12 12 
12 12 12 12 12 12 12 12 12 12 12 12 12 12 12 12 12 12 12 12 12 12 12 12 12 12 12 12 12 12 12 12 12 12 12 12 12 12 12 12 12 12 12 12 12 12 12 12 12 12  
12 12 12 12 12 12 12 20 20 20 20 20 20 20 12 12 12 12 12 20 20 20 20 20 20 20 12 12 12 12 12 12 12 20 20 20 20 20 20 20 20 12 12 12 12 12 12 12 12 12 
12 12 12 12 12 12 12 41 40 40 40 40 40 41 19 20 20 20 21 41 10 10 11 10 10 10 23 20 20 20 20 20 22 10 43 11 11 11 11 11 11 23 12 12 12 12 12 12 12 12 
12 12 12 12 12 12 12 41 40 45 45 45 40 41 41 42 41 41 41 41 10 14 15 15 15 16 10 41 41 41 41 41 41 41 11 10 10 10 10 10 10 11 17 12 12 12 12 12 12 12
12 12 12 12 12 12 12 41 40 45 45 45 40 41 41 41 41 42 41 41 43 17 12 12 12 12 10 41 41 41 41 41 42 41 11 10 10 10 11 10 10 11 17 12 12 12 12 12 12 12 
12 12 12 12 12 12 12 41 40 45 45 45 40 41 41 41 41 41 41 41 10 17 12 12 12 12 11 41 41 41 42 41 41 42 11 10 11 10 10 10 10 11 17 12 12 12 12 12 12 12 
12 12 12 12 12 12 12 41 40 45 45 45 40 41 41 41 42 41 41 41 10 19 20 20 20 21 10 41 42 41 42 41 41 41 11 10 10 43 10 10 10 11 17 12 12 12 12 12 12 12 
12 12 12 12 12 12 12 41 40 40 45 40 40 41 41 42 41 41 41 41 11 10 10 10 10 10 10 41 41 41 41 41 41 41 10 11 11 10 10 10 11 10 17 12 12 12 12 12 12 12 
12 12 12 12 12 12 12 41 41 42 10 42 41 41 41 41 41 41 41 41 41 41 11 10 11 41 41 41 42 41 41 41 41 42 41 41 41 11 10 11 14 15 12 12 12 12 12 12 12 12 
12 12 12 12 12 12 12 41 41 41 10 41 41 41 41 41 41 41 42 41 41 41 11 10 11 41 41 41 41 41 41 42 41 41 42 41 42 43 10 11 17 12 12 12 12 12 12 12 12 12 
12 12 12 12 12 12 12 15 16 41 10 41 41 42 42 41 41 41 41 42 41 41 11 10 11 41 42 41 41 41 41 41 41 41 41 41 41 11 10 11 17 12 12 12 12 12 12 12 12 12 
12 12 12 12 12 12 12 12 12 41 10 41 41 41 41 42 41 41 41 41 41 41 43 10 43 41 41 41 41 41 42 41 42 41 42 41 42 11 10 11 17 12 12 12 12 12 12 12 12 12 
12 12 12 12 12 12 12 12 21 41 10 41 42 41 41 41 41 41 42 41 41 42 11 10 11 42 41 42 41 41 41 41 41 41 42 10 11 10 10 11 17 12 12 12 12 12 12 12 12 12 
12 12 12 12 12 12 12 22 10 10 10 41 42 41 41 42 41 41 41 42 41 41 11 10 11 42 41 41 41 41 41 42 41 41 41 11 10 10 10 11 17 12 12 12 12 12 12 12 12 12 
12 12 12 12 12 12 12 26 10 41 41 41 41 42 41 41 41 41 41 41 42 10 43 10 11 43 41 41 42 41 41 41 41 42 41 11 10 10 11 10 17 12 12 12 12 12 12 12 12 12 
12 12 12 12 12 12 12 26 10 41 41 41 10 43 11 43 11 11 11 11 11 11 10 10 10 10 11 11 43 11 11 11 11 11 11 10 10 11 10 41 17 12 12 12 12 12 12 12 12 12 
12 12 12 12 12 12 12 26 10 41 42 41 11 11 10 10 10 10 10 10 10 10 10 10 10 10 10 10 10 10 10 10 10 10 10 10 10 11 10 14 12 12 12 12 12 12 12 12 12 12 
12 12 12 12 12 12 12 24 10 10 41 41 10 10 11 11 11 11 11 11 11 11 10 10 10 11 11 11 11 11 11 11 43 11 11 10 10 11 10 17 12 12 12 12 12 12 12 12 12 12 
12 12 12 12 12 12 12 12 26 10 41 41 10 41 41 41 41 41 41 41 41 10 11 10 11 10 41 41 41 41 41 41 41 42 41 11 10 11 10 17 12 12 12 12 12 12 12 12 12 12 
12 12 12 12 12 12 12 12 26 10 42 41 10 41 41 41 42 41 41 41 41 41 11 10 11 44 42 41 41 41 42 41 41 41 41 11 10 11 11 17 12 12 12 12 12 12 12 12 12 12 
12 12 12 12 12 12 12 12 26 10 41 41 10 10 10 41 41 41 42 41 41 42 11 10 11 10 10 10 10 10 10 42 41 42 41 43 10 11 10 17 12 12 12 12 12 12 12 12 12 12 
12 12 12 12 12 12 12 12 26 10 41 41 41 41 10 41 42 41 41 41 41 41 11 10 11 10 10 10 10 10 10 10 43 41 41 11 10 43 10 17 12 12 12 12 12 12 12 12 12 12 
12 12 12 12 12 12 12 21 10 41 41 41 41 41 10 41 41 41 41 41 42 41 11 10 43 41 41 43 10 10 10 10 10 41 41 11 10 11 10 17 12 12 12 12 12 12 12 12 12 12 
12 12 12 12 12 12 12 46 10 41 42 41 41 41 10 41 42 41 41 41 41 42 11 10 11 41 41 10 10 10 10 10 11 10 41 43 10 11 10 17 12 12 12 12 12 12 12 12 12 12 
12 12 12 12 12 12 12 26 10 10 10 10 10 10 10 41 41 41 42 41 41 41 11 10 43 42 41 10 10 10 10 10 10 43 41 10 11 10 10 17 12 12 12 12 12 12 12 12 12 12 
12 12 12 12 12 12 12 26 10 10 11 10 43 10 10 42 41 41 41 41 42 41 43 10 11 41 41 43 10 10 10 10 10 10 42 41 10 41 14 12 12 12 12 12 12 12 12 12 12 12 
12 12 12 12 12 12 12 26 10 10 10 10 10 10 10 41 41 41 41 41 41 41 11 10 11 41 41 10 41 41 42 10 10 10 41 10 10 10 17 12 12 12 12 12 12 12 12 12 12 12 
12 12 12 12 12 12 12 26 10 10 10 10 10 11 10 42 41 42 41 41 42 41 11 10 43 41 42 30 31 31 31 31 31 32 42 10 10 10 17 12 12 12 12 12 12 12 12 12 12 12 
12 12 12 12 12 12 12 26 10 10 10 10 10 10 10 41 41 41 41 41 42 41 11 10 11 41 41 37 38 38 38 38 38 33 41 10 10 11 17 12 12 12 12 12 12 12 12 12 12 12 
12 12 12 12 12 12 12 26 10 10 10 43 10 10 10 41 41 41 42 41 41 41 11 10 11 42 41 37 38 38 38 38 38 33 41 10 10 10 17 12 12 12 12 12 12 12 12 12 12 12 
12 12 12 12 12 12 12 24 10 41 41 41 41 41 41 41 41 41 42 41 41 41 10 11 10 41 41 36 38 38 38 38 35 34 41 11 10 10 19 12 12 12 12 12 12 12 12 12 12 12 
12 12 12 12 12 12 12 12 42 41 41 42 41 42 41 41 42 41 41 10 10 10 10 10 10 10 40 40 37 38 38 33 40 42 42 10 10 10 10 19 12 12 12 12 12 12 12 12 12 12 
12 12 12 12 12 12 12 12 41 41 42 41 41 41 41 41 41 41 10 10 10 10 10 10 10 10 38 38 36 35 35 34 40 10 43 10 10 10 43 10 17 12 12 12 12 12 12 12 12 12 
12 12 12 12 12 12 12 12 39 41 41 41 41 41 41 39 39 39 10 11 10 10 10 10 10 11 40 40 40 40 40 40 10 10 10 10 10 11 10 10 17 12 12 12 12 12 12 12 12 12 
12 12 12 12 12 12 12 12 39 41 39 39 39 39 39 39 41 42 10 10 11 10 10 10 43 10 10 10 10 41 42 41 10 10 10 10 43 41 10 10 17 12 12 12 12 12 12 12 12 12 
12 12 12 12 12 12 12 12 39 39 39 39 41 41 41 41 41 41 10 10 10 10 10 10 10 10 10 10 10 10 10 10 10 10 41 10 10 10 10 10 17 12 12 12 12 12 12 12 12 12 
12 12 12 12 12 12 12 12 39 41 41 42 41 10 41 14 15 15 16 10 43 10 10 10 11 10 10 14 15 15 16 43 10 10 10 10 10 10 11 10 17 12 12 12 12 12 12 12 12 12 
12 12 12 12 12 12 12 12 42 42 41 41 41 41 14 12 12 12 12 16 10 10 10 10 10 10 14 12 12 12 12 26 10 41 10 43 41 10 10 10 17 12 12 12 12 12 12 12 12 12 
12 12 12 12 12 12 12 12 15 15 15 15 15 15 12 12 12 12 12 12 15 15 15 15 15 15 12 12 12 12 12 16 43 11 10 10 10 10 14 15 12 12 12 12 12 12 12 12 12 12 
12 12 12 12 12 12 12 12 12 12 12 12 12 12 12 12 12 12 12 12 12 12 12 12 12 12 12 12 12 12 12 12 15 15 15 15 15 15 12 12 12 12 12 12 12 12 12 12 12 12 
12 12 12 12 12 12 12 12 12 12 12 12 12 12 12 12 12 12 12 12 12 12 12 12 12 12 12 12 12 12 12 12 12 12 12 12 12 12 12 12 12 12 12 12 12 12 12 12 12 12 
12 12 12 12 12 12 12 12 12 12 12 12 12 12 12 12 12 12 12 12 12 12 12 12 12 12 12 12 12 12 12 12 12 12 12 12 12 12 12 12 12 12 12 12 12 12 12 12 12 12 
12 12 12 12 12 12 12 12 12 12 12 12 12 12 12 12 12 12 12 12 12 12 12 12 12 12 12 12 12 12 12 12 12 12 12 12 12 12 12 12 12 12 12 12 12 12 12 12 12 12 
12 12 12 12 12 12 12 12 12 12 12 12 12 12 12 12 12 12 12 12 12 12 12 12 12 12 12 12 12 12 12 12 12 12 12 12 12 12 12 12 12 12 12 12 12 12 12 12 12 12 
12 12 12 12 12 12 12 12 12 12 12 12 12 12 12 12 12 12 12 12 12 12 12 12 12 12 12 12 12 12 12 12 12 12 12 12 12 12 12 12 12 12 12 12 12 12 12 12 12 12 